#Beyond Typus Classic extra countries
#Release version 1.0

#Italy
EBA = "countries/Bari.txt"
ANC = "countries/Ancona.txt"
VRN = "countries/Verona.txt"
NIC = "countries/Nice.txt"
RMA = "countries/Rome.txt"
BSC = "countries/Brescia.txt"
BRG = "countries/Bergamo.txt"
PAV = "countries/Pavia.txt"
CMN = "countries/Cremona.txt"
VCZ = "countries/Vicenza.txt"
PAD = "countries/Padua.txt"
PCZ = "countries/Piacenza.txt"
PIE = "countries/Piedmont.txt"
TSI = "countries/TwoSicilies.txt"
RMG = "countries/Romagna.txt"

#Japan (from Iaponia Universalis)
HNM = "countries/Honma.txt"
TGS = "countries/Togashi.txt"
TSC = "countries/Tsuchimochi.txt"
OMR = "countries/Omura.txt"
KSI = "countries/Kasai.txt"
MYI = "countries/Miyoshi.txt"

#Caucasus (from Crossroads)
LEK = "countries/Lekia.txt"
KTG = "countries/Kaitag.txt"
DID = "countries/Didoya.txt"
VAK = "countries/Vainakhia.txt"
ALA = "countries/Alania.txt"
KBR = "countries/Kabardia.txt"
BLK = "countries/Balkaria.txt"
KCY = "countries/Karachay.txt"
ABZ = "countries/Abazinia.txt"
ABK = "countries/Abkhazia.txt"
MGL = "countries/Mingrelia.txt"
GUR = "countries/Guria.txt"
KAH = "countries/Kakheti.txt"
DRB = "countries/Derbent.txt"
QUB = "countries/Quba.txt"
BAK = "countries/Baku.txt"
JVD = "countries/Javad.txt"
TAL = "countries/Talysh.txt"
GNJ = "countries/Ganja.txt"
SVN = "countries/Svaneti.txt"
KRT = "countries/Kartli.txt"
CAU = "countries/CaucasusImamate.txt"
TUM = "countries/Tumen.txt"
DJR = "countries/Chartalakh.txt"
MOU = "countries/Transcaucasia.txt"
LAZ = "countries/Lazistan.txt"
UDI = "countries/Udi.txt"

LTE = "countries/LatinEmpire.txt"
A7D = "countries/Andorra.txt"

#Siberian minors
SMY = "countries/Samoyed.txt"
OST = "countries/Yugra.txt"
TSA = "countries/Tunguska.txt"
YTA = "countries/Yakutia.txt"

#South east asia (from Suvarnabhumi: The Land of gold)
ARU = "countries/Aru.txt"
BRS = "countries/Barus.txt"
KET = "countries/Kengtung.txt"
YGW = "countries/Yawnghwe.txt"
PAH = "countries/Pahang.txt"
WTL = "countries/Wethali.txt"
KEL = "countries/Kelantan.txt"
JMB = "countries/Jambi.txt"
BEU = "countries/Berau.txt"
IDG = "countries/Indragiri.txt"
MMT = "countries/MongMit.txt"
SKD = "countries/Sukadana.txt"
LDA = "countries/Landak.txt"
PNT = "countries/Pontianak.txt"
BNE = "countries/Bone.txt"
WJO = "countries/Wajo.txt"
SPP = "countries/Soppeng.txt"
YGK = "countries/Yogyakarta.txt"
SRK = "countries/Surakarta.txt"
##SMD = "countries/Sumedang.txt"##
SRB = "countries/Surabaya.txt"
SPR = "countries/Selaparang.txt"
BMA = "countries/Bima.txt"
SIA = "countries/Siam.txt"
BRM = "countries/Burma.txt"
FMA = "countries/Ma-i.txt"
SVJ = "countries/Srivijaya.txt"
PHM = "countries/Phimai.txt"
FNG = "countries/Fang.txt"
SMB = "countries/Sumbawa.txt"
KME = "countries/KhmerEmpire.txt"
JAV = "countries/java-sunda.txt"
VTM = "countries/Vietnam.txt"
MGG = "countries/Mangkunegaran.txt"